16 16
1     0 160 128 160 128 160 128 160 128 160 96 0 
1     0 160 128 160 128 160 128 160 128 160 96 0 
1     0 160 128 160 128 160 128 160 128 160 96 0 
1     0 160 128 160 128 160 128 160 128 160 96 0 
1     0 160 128 160 128 160 128 160 128 160 96 0 
1     0 160 128 160 128 160 128 160 128 160 96 0 
1     0 160 128 160 128 160 128 160 128 160 96 0 
1     0 160 128 160 128 160 128 160 128 160 96 0 
1     0 160 128 160 128 160 128 160 128 160 96 0 
1     0 160 128 160 128 160 128 160 128 160 96 0 
0     96 128 128 160 128 160 128 160 128 160 96 0 
0     96 128 128 160 128 160 128 160 128 160 96 0 
0     96 128 128 160 128 160 128 160 128 160 96 0 
0     96 128 128 160 128 160 128 160 128 160 96 0 
0     96 128 128 160 128 160 128 160 128 160 96 0 
0     96 128 128 160 128 160 128 160 128 160 96 0 
1     0 160 128 160 128 160 128 160 128 160 96 0 
0     0 160 128 160 128 160 128 160 128 160 96 0 
0     0 160 128 160 128 160 128 160 128 160 96 0 
0     0 160 128 160 128 160 128 160 128 160 96 0 
0     0 160 128 160 128 160 128 160 128 160 96 0 
0     0 160 128 160 128 160 128 160 128 160 96 0 
0     0 160 128 160 128 160 128 160 128 160 96 0 
0     0 160 128 160 128 160 128 160 128 160 96 0 
0     0 160 128 160 128 160 128 160 128 160 96 0 
1     0 160 128 160 128 160 128 160 128 160 96 0 
0     0 160 128 160 128 160 128 160 128 160 96 0 
0     0 160 128 160 128 160 128 160 128 160 96 0 
0     0 160 128 160 128 160 128 160 128 160 96 0 
0     0 160 128 160 128 160 128 160 128 160 96 0 
0     0 160 128 160 128 160 128 160 128 160 96 0 
0     96 128 128 160 128 160 128 160 128 160 96 0 
1     0 160 128 160 128 160 128 160 128 160 96 0 
0     0 160 128 160 128 160 128 160 128 160 96 0 
1     0 160 128 160 128 160 128 160 128 160 96 0 
1     0 160 128 160 128 160 128 160 128 160 96 0 
1     0 160 128 160 128 160 128 160 128 160 96 0 
1     0 160 128 160 128 160 128 160 128 160 96 0 
1     0 160 128 160 128 160 128 160 128 160 96 0 
1     0 160 128 160 128 160 128 160 128 160 96 0 
0     0 160 128 160 128 160 128 160 128 160 96 0 
1     0 160 128 160 128 160 128 160 128 160 96 0 
0     0 160 128 160 128 160 128 160 128 160 96 0 
0     0 160 128 160 128 160 128 160 128 160 96 0 
0     0 160 128 160 128 160 128 160 128 160 96 0 
0     0 160 128 160 128 160 128 160 128 160 96 0 
0     0 160 128 160 128 160 128 160 128 160 96 0 
0     96 128 128 160 128 160 128 160 128 160 96 0 
1     0 160 128 160 128 160 128 160 128 160 96 0 
0     0 160 128 160 128 160 128 160 128 160 96 0 
1     0 160 128 160 128 160 128 160 128 160 96 0 
0     0 160 128 160 128 160 128 160 128 160 96 0 
0     0 160 128 160 128 160 128 160 128 160 96 0 
0     0 160 128 160 128 160 128 160 128 160 96 0 
0     0 160 128 160 128 160 128 160 128 160 96 0 
1     0 160 128 160 128 160 128 160 128 160 96 0 
0     0 160 128 160 128 160 128 160 128 160 96 0 
1     0 160 128 160 128 160 128 160 128 160 96 0 
0     0 96 128 160 128 160 128 160 128 160 96 0 
0     0 96 128 160 128 160 128 160 128 160 96 0 
1     0 160 128 160 128 160 128 160 128 160 96 0 
1     0 160 128 160 128 160 128 160 128 160 96 0 
1     0 160 128 160 128 160 128 160 128 160 96 0 
0     96 128 128 160 128 160 128 160 128 160 96 0 
1     0 160 128 160 128 160 128 160 128 160 96 0 
0     0 160 128 160 128 160 128 160 128 160 96 0 
1     0 160 128 160 128 160 128 160 128 160 96 0 
0     0 160 128 160 128 160 128 160 128 160 96 0 
1     0 160 128 160 128 160 128 160 128 160 96 0 
1     0 160 128 160 128 160 128 160 128 160 96 0 
0     0 160 128 160 128 160 128 160 128 160 96 0 
1     0 160 128 160 128 160 128 160 128 160 96 0 
0     0 160 128 160 128 160 128 160 128 160 96 0 
1     0 160 128 160 128 160 128 160 128 160 96 0 
0     0 96 128 160 128 160 128 160 128 160 96 0 
0     0 96 128 160 128 160 128 160 128 160 96 0 
1     0 160 128 160 128 160 128 160 128 160 96 0 
0     0 160 128 160 128 160 128 160 128 160 96 0 
1     0 160 128 160 128 160 128 160 128 160 96 0 
0     96 128 128 160 128 160 128 160 128 160 96 0 
1     0 160 128 160 128 160 128 160 128 160 96 0 
0     0 160 128 160 128 160 128 160 128 160 96 0 
1     0 160 128 160 128 160 128 160 128 160 96 0 
0     0 160 128 160 128 160 128 160 128 160 96 0 
1     0 160 128 160 128 160 128 160 128 160 96 0 
0     0 96 128 160 128 160 128 160 128 160 96 0 
0     0 160 128 160 128 160 128 160 128 160 96 0 
1     0 160 128 160 128 160 128 160 128 160 96 0 
0     0 160 128 160 128 160 128 160 128 160 96 0 
1     0 160 128 160 128 160 128 160 128 160 96 0 
0     0 96 128 160 128 160 128 160 128 160 96 0 
0     0 96 128 160 128 160 128 160 128 160 96 0 
1     0 160 128 160 128 160 128 160 128 160 96 0 
0     0 160 128 160 128 160 128 160 128 160 96 0 
1     0 160 128 160 128 160 128 160 128 160 96 0 
0     96 128 128 160 128 160 128 160 128 160 96 0 
1     0 160 128 160 128 160 128 160 128 160 96 0 
0     0 96 128 160 128 160 128 160 128 160 96 0 
1     0 160 128 160 128 160 128 160 128 160 96 0 
0     0 160 128 160 128 160 128 160 128 160 96 0 
1     0 160 128 160 128 160 128 160 128 160 96 0 
1     0 160 128 160 128 160 128 160 128 160 96 0 
1     0 160 128 160 128 160 128 160 128 160 96 0 
1     0 160 128 160 128 160 128 160 128 160 96 0 
0     0 160 128 160 128 160 128 160 128 160 96 0 
1     0 160 128 160 96 256 96 256 128 160 96 0 
0     0 96 128 160 128 160 128 160 128 160 96 0 
0     0 96 128 160 128 160 128 160 128 160 96 0 
1     0 160 128 160 128 160 128 160 128 160 96 0 
0     0 160 128 160 128 160 128 160 128 160 96 0 
1     0 160 128 160 128 160 128 160 128 160 96 0 
0     96 128 128 160 128 160 128 160 128 160 96 0 
1     0 160 128 160 128 160 128 160 128 160 96 0 
0     0 96 128 160 128 160 128 160 128 160 96 0 
1     0 160 128 160 128 160 128 160 128 160 96 0 
0     0 160 128 160 128 160 128 160 128 160 96 0 
0     0 160 128 160 128 160 128 160 128 160 96 0 
0     0 160 128 160 128 160 128 160 128 160 96 0 
0     0 160 128 160 128 160 128 160 128 160 96 0 
0     0 160 128 160 128 160 128 160 128 160 96 0 
0     0 160 128 160 128 160 128 160 128 160 96 0 
1     0 160 128 160 128 160 128 160 128 160 96 0 
1     0 96 192 64 192 64 192 64 192 64 0 320 
0     0 96 128 160 128 160 128 160 128 160 96 0 
1     0 160 128 160 128 160 128 160 128 160 96 0 
0     0 160 128 160 128 160 128 160 128 160 96 0 
1     0 160 128 160 128 160 128 160 128 160 96 0 
0     96 128 128 160 128 160 128 160 128 160 96 0 
1     0 160 128 160 128 160 128 160 128 160 96 0 
0     0 96 128 160 128 160 128 160 128 160 96 0 
1     0 160 128 160 128 160 128 160 128 160 96 0 
1     0 160 256 224 128 160 128 160 128 160 96 0 
1     0 160 256 224 128 160 128 160 128 160 96 0 
1     0 160 256 224 128 160 128 160 128 160 96 0 
1     0 160 256 224 128 160 128 160 128 160 96 0 
1     0 160 256 224 128 160 128 160 128 160 96 0 
1     0 160 256 224 128 160 128 160 64 224 96 0 
1     0 160 128 160 128 160 128 160 128 160 96 0 
0     0 96 128 160 128 160 128 160 128 160 96 0 
0     0 96 128 160 128 160 128 160 128 160 96 0 
1     0 160 128 160 128 160 128 160 128 160 96 0 
0     0 160 128 160 128 160 128 160 128 160 96 0 
1     0 160 128 160 128 160 128 160 128 160 96 0 
0     96 128 128 160 128 160 128 160 128 160 96 0 
1     0 160 128 160 128 160 128 160 128 160 96 0 
0     0 96 128 160 128 160 128 160 128 160 96 0 
0     0 96 128 160 128 160 128 160 128 160 96 0 
0     0 96 128 160 128 160 128 160 128 160 96 0 
0     0 96 128 160 128 160 128 160 128 160 96 0 
0     0 96 128 160 128 160 128 160 128 160 96 0 
0     0 96 128 160 128 160 128 160 128 160 96 0 
0     0 96 128 160 128 160 128 160 128 160 96 0 
0     0 96 192 64 128 160 128 160 128 160 96 0 
0     0 96 128 160 128 160 128 160 128 160 96 0 
0     0 96 128 160 128 160 128 160 128 160 96 0 
0     0 96 128 160 128 160 128 160 128 160 96 0 
1     0 160 128 160 128 160 128 160 128 160 96 0 
0     0 160 128 160 128 160 128 160 128 160 96 0 
1     0 160 128 160 128 160 128 160 128 160 96 0 
0     96 128 128 160 128 160 128 160 128 160 96 0 
1     0 160 128 160 128 160 128 160 128 160 96 0 
0     0 96 128 160 128 160 128 160 128 160 96 0 
0     0 96 128 160 128 160 128 160 128 160 96 0 
0     0 96 128 160 128 160 128 160 128 160 96 0 
0     0 96 128 160 128 160 128 160 128 160 96 0 
0     0 96 128 160 128 160 128 160 128 160 96 0 
0     0 96 128 160 128 160 128 160 128 160 96 0 
0     0 96 128 160 128 160 128 160 128 160 96 0 
0     0 96 128 160 128 160 128 160 128 160 96 0 
0     0 96 128 160 128 160 128 160 128 160 96 0 
0     0 96 128 160 128 160 128 160 128 160 96 0 
0     0 96 128 160 128 160 128 160 128 160 96 0 
1     0 160 128 160 128 160 128 160 128 160 96 0 
0     0 160 128 160 128 160 128 160 128 160 96 0 
1     0 160 128 160 128 160 128 160 128 160 96 0 
0     96 128 128 160 128 160 128 160 128 160 96 0 
1     0 160 128 160 128 160 128 160 128 160 96 0 
1     0 160 128 160 128 160 128 160 128 160 96 0 
1     0 160 128 160 128 160 128 160 128 160 96 0 
1     0 160 256 224 128 160 128 160 128 160 96 0 
1     0 160 256 224 128 160 128 160 128 160 96 0 
1     0 160 256 224 128 160 128 160 128 160 96 0 
1     0 160 256 224 128 160 128 160 128 160 96 0 
1     0 160 256 224 128 160 128 160 128 160 96 0 
1     0 160 256 224 128 160 128 160 128 160 96 0 
1     0 160 96 192 128 160 96 192 128 160 96 0 
1     0 160 128 160 128 160 128 160 128 160 96 0 
1     0 160 128 160 128 160 128 160 128 160 96 0 
1     0 160 128 160 128 160 128 160 128 160 96 0 
0     0 160 128 160 128 160 128 160 128 160 96 0 
1     0 160 128 160 128 160 128 160 128 160 96 0 
0     96 128 128 160 128 160 128 160 128 160 96 0 
1     0 160 128 160 128 160 128 160 128 160 96 0 
0     0 160 128 160 128 160 128 160 128 160 96 0 
0     0 160 128 160 128 160 128 160 128 160 96 0 
0     0 160 128 160 128 160 128 160 128 160 96 0 
0     0 160 128 160 128 160 128 160 128 160 96 0 
0     0 160 128 160 128 160 128 160 128 160 96 0 
0     0 160 128 160 128 160 128 160 128 160 96 0 
0     0 160 128 160 128 160 128 160 128 160 96 0 
0     0 160 128 160 128 160 128 160 128 160 96 0 
0     0 160 128 160 128 160 128 160 128 160 96 0 
0     0 160 128 160 128 160 128 160 128 160 96 0 
0     0 160 128 160 128 160 128 160 128 160 96 0 
0     0 160 128 160 128 160 128 160 128 160 96 0 
0     0 160 128 160 128 160 128 160 128 160 96 0 
1     0 160 128 160 128 160 128 160 128 160 96 0 
0     96 128 128 160 128 160 128 160 128 160 96 0 
1     0 160 128 160 128 160 128 160 128 160 96 0 
0     0 160 128 160 128 160 128 160 128 160 96 0 
0     0 160 128 160 128 160 128 160 128 160 96 0 
0     0 160 128 160 128 160 128 160 128 160 96 0 
0     0 160 128 160 128 160 128 160 128 160 96 0 
0     0 160 128 160 128 160 128 160 128 160 96 0 
0     0 160 128 160 128 160 128 160 128 160 96 0 
0     0 160 128 160 128 160 128 160 128 160 96 0 
0     0 160 128 160 128 160 128 160 128 160 96 0 
0     0 160 128 160 128 160 128 160 128 160 96 0 
0     0 160 128 160 128 160 128 160 128 160 96 0 
0     0 160 128 160 128 160 128 160 128 160 96 0 
0     0 160 128 160 128 160 128 160 128 160 96 0 
0     0 160 128 160 128 160 128 160 128 160 96 0 
1     0 160 128 160 128 160 128 160 128 160 96 0 
0     96 128 128 160 128 160 128 160 128 160 96 0 
1     0 160 128 160 128 160 128 160 128 160 96 0 
0     0 160 128 160 128 160 128 160 128 160 96 0 
0     0 160 128 160 128 160 128 160 128 160 96 0 
0     0 160 128 160 128 160 128 160 128 160 96 0 
0     0 160 128 160 128 160 128 160 128 160 96 0 
0     0 160 128 160 128 160 128 160 128 160 96 0 
0     0 160 128 160 128 160 128 160 128 160 96 0 
0     0 160 128 160 128 160 128 160 128 160 96 0 
0     0 160 128 160 128 160 128 160 128 160 96 0 
0     0 160 128 160 128 160 128 160 128 160 96 0 
0     0 160 128 160 128 160 128 160 128 160 96 0 
0     0 160 128 160 128 160 128 160 128 160 96 0 
0     0 160 128 160 128 160 128 160 128 160 96 0 
0     0 160 128 160 128 160 128 160 128 160 96 0 
1     0 160 128 160 128 160 128 160 128 160 96 0 
0     96 128 128 160 128 160 128 160 128 160 96 0 
1     0 160 128 160 128 160 128 160 128 160 96 0 
1     0 160 128 160 128 160 128 160 128 160 96 0 
1     0 160 128 160 128 160 128 160 128 160 96 0 
1     0 160 128 160 128 160 128 160 128 160 96 0 
1     0 160 128 160 128 160 128 160 128 160 96 0 
1     0 160 128 160 128 160 128 160 128 160 96 0 
1     0 160 128 160 128 160 128 160 128 160 96 0 
1     0 160 128 160 128 160 128 160 128 160 96 0 
1     0 160 128 160 128 160 128 160 128 160 96 0 
1     0 160 128 160 128 160 128 160 128 160 96 0 
1     0 160 128 160 128 160 128 160 128 160 96 0 
1     0 160 128 160 128 160 128 160 128 160 96 0 
1     0 160 128 160 128 160 128 160 128 160 96 0 
1     0 160 128 160 128 160 128 160 128 160 96 0 
1     0 160 128 160 128 160 128 160 128 160 96 0 
0     96 128 128 160 128 160 128 160 128 160 96 0 
